###
##
####
#   #    #
#   #    #
## #### ##
#        #
#        #
##########