##########
#   #    #
#   #    #
## #### ##
#    #   #
#    #   #
#  #######
#        #
#        #
## #### ##
#    #   #
#    #   #
#  #######
#  #  #  #
#        #
##########