##########
#   #    #
#   #    #
## #### ##
#        #
#        #
#  #######
#  #  #  #
#        #
##########