####1F2981#1F2981#1F2981#1F2981#1F2981#1F2981#1F2981
###FFFFFF#1F2981#1F2981#1F2981#1F2981#1F2981#1F2981#1F2981
#####1F2981#1F2981#1F2981#1F2981#1F2981#1F2981
##497082#497082#497082##1F2981#1F2981#1F2981#1F2981#
##497082#497082#497082##1F2981#1F2981#1F2981#1F2981#
###FFFFFF#####FFFFFF##
##56633B#56633B#56633B#56633B#56633B#56633B#56633B#56633B#
##56633B#56633B#56633B#56633B#56633B#56633B#56633B#56633B#
##########
Number of rooms: 3