##########
##33D62E#33D62E#33D62E##CB9A8D#CB9A8D#CB9A8D#CB9A8D#
##33D62E#33D62E#33D62E##CB9A8D#CB9A8D#CB9A8D#CB9A8D#
###FFFFFF#####FFFFFF##
##66025C#66025C#66025C#66025C#66025C#66025C#66025C#66025C#
##66025C#66025C#66025C#66025C#66025C#66025C#66025C#66025C#
##########
Number of rooms: 3