##########
##9CB5F0#9CB5F0#9CB5F0##2F96E1#2F96E1#2F96E1#2F96E1#
##9CB5F0#9CB5F0#9CB5F0##2F96E1#2F96E1#2F96E1#2F96E1#
###FFFFFF#####FFFFFF##
##92AEEC#92AEEC#92AEEC#92AEEC#92AEEC#92AEEC#92AEEC#92AEEC#
##92AEEC#92AEEC#92AEEC#92AEEC#92AEEC#92AEEC#92AEEC#92AEEC#
##92AEEC#92AEEC#######
##92AEEC#92AEEC##E1F2F0#E1F2F0##51F67E#51F67E#
##92AEEC#92AEEC#FFFFFF#E1F2F0#E1F2F0#FFFFFF#51F67E#51F67E#
##########
Number of rooms: 5